Trace,IPC,L1I Access,L1I Hit,L1I Miss,L1I MPKI,Branch MPKI,L1D Access,L1D Hit,L1D Miss,L1D MPKI,L2C MPKI,LLC MPKI,L1I Load Access,L1I Load Hit,L1I Load Miss,L1I Load MPKI
client_001,1.5513,25490980,25221844,269136,5.3827,0,11758887,11344734,414153,8.2831,5.0385,2.8255,5160992,5021962,139030,2.7806
client_002,1.85776,28786294,28295090,491204,9.8241,0,12317444,12076649,240795,4.8159,4.1464,1.0614,6493088,6173326,319762,6.3952
client_003,1.14977,23564446,23130703,433743,8.6749,0,11292530,10885186,407344,8.1469,7.1923,5.2298,4753954,4478211,275743,5.5149
client_004,1.79069,27984383,27442445,541938,10.8388,0,12099074,11571101,527973,10.5595,4.8303,1.74,5836388,5511349,325039,6.5008
client_005,1.44344,31267946,30627895,640051,12.801,0,12843119,12455809,387310,7.7462,6.5364,4.8177,6664814,6249583,415231,8.3046
client_006,1.49025,22727169,22045589,681580,13.6316,0,9436239,8933577,502662,10.0532,8.9491,5.2171,4894622,4515330,379292,7.5858
client_007,1.56381,26070097,25246545,823552,16.471,0,12384525,11819052,565473,11.3095,3.504,2.4011,4633313,4197638,435675,8.7135
client_008,1.63532,28464768,27719395,745373,14.9075,0,12046542,11176903,869639,17.3928,6.1837,2.9018,6363478,5840581,522897,10.4579
server_001,1.52228,23333984,22823064,510920,10.2184,0,10745112,10335089,410023,8.2005,8.2222,4.4498,4996112,4751328,244784,4.8957
server_002,1.38116,37027223,36351285,675938,13.5188,0,14901882,14901498,384,0.0077,0.0027,0.0015,6689776,6322568,367208,7.3442
server_003,1.56526,27436704,26513646,923058,18.4612,0,11200869,10472908,727961,14.5592,14.515,3.0886,6115202,5584896,530306,10.6061
server_004,1.13679,33857220,32740284,1116936,22.3387,0,12628038,10623842,2004196,40.0839,15.3406,1.9,5888898,5298441,590457,11.8091
server_009,1.13525,34045514,32937791,1107723,22.1545,0,12730888,10485807,2245081,44.9016,15.0713,1.2193,5752880,5173193,579687,11.5937
server_010,1.38282,29383249,28151247,1232002,24.64,0,11869464,10253623,1615841,32.3168,16.456,1.2366,5719361,5071082,648279,12.9656
server_011,1.8603,24512436,23227200,1285236,25.7047,0,10736674,10103970,632704,12.6541,16.4276,1.8163,5700215,5029968,670247,13.4049
server_012,1.94783,24112598,22707242,1405356,28.1071,0,10627157,9991036,636121,12.7224,18.6551,1.3109,5715028,4975461,739567,14.7913
server_013,1.89806,24021420,22542999,1478421,29.5684,0,10622148,9975028,647120,12.9424,19.6584,1.4621,5666941,4907420,759521,15.1904
server_014,1.42486,33958946,32568474,1390472,27.8094,0,14996957,14935491,61466,1.2293,1.3144,0.9844,6705770,5837596,868174,17.3635
server_015,1.47783,33308041,31837140,1470901,29.418,0,15201362,15200960,402,0.008,0.0024,0.0013,6731956,5834124,897832,17.9566
server_016,1.87389,25059479,22669544,2389935,47.7987,0,11476148,10647784,828364,16.5673,8.3851,0.4897,4970301,3584440,1385861,27.7172
server_017,0.415104,29076399,26917057,2159342,43.1868,0,12804212,11066442,1737770,34.7554,32.7679,24.3531,5383420,4062966,1320454,26.4091
server_018,0.425471,28362938,25867411,2495527,49.9105,0,13182417,11378370,1804047,36.0809,33.8849,24.4163,5475248,3921644,1553604,31.0721
server_019,0.40645,29092301,26891633,2200668,44.0134,0,12738923,10950366,1788557,35.7711,33.6112,25.6781,5350060,4001586,1348474,26.9695
server_020,0.427709,28349314,25835416,2513898,50.278,0,13166544,11373959,1792585,35.8517,33.7866,24.403,5479000,3919252,1559748,31.195
server_021,0.432006,27548628,25018713,2529915,50.5983,0,13269103,11455025,1814078,36.2816,34.1594,24.3431,5499563,3922220,1577343,31.5469
server_022,0.43398,27511852,24979852,2532000,50.64,0,13280664,11462569,1818095,36.3619,34.2592,24.2141,5498326,3927242,1571084,31.4217
server_023,1.69903,28405677,25655793,2749884,54.9977,0,12556553,11597640,958913,19.1783,10.5015,0.6555,5698072,4101168,1596904,31.9381
server_024,1.65763,28979662,26120990,2858672,57.1734,0,12781887,11791848,990039,19.8008,9.0019,0.7448,5817749,4171300,1646449,32.929
server_025,1.63833,31257196,28485154,2772042,55.4408,0,13174914,12273822,901092,18.0218,9.5758,0.3888,6466696,4869124,1597572,31.9514
server_026,1.64156,30590215,27446144,3144071,62.8814,0,12914606,11850569,1064037,21.2807,11.6176,0.3902,6130091,4339431,1790660,35.8132
server_027,1.63484,30806268,27630952,3175316,63.5063,0,12964908,11946379,1018529,20.3706,10.9567,0.4664,6182822,4376279,1806543,36.1309
server_028,1.54304,31251632,27975863,3275769,65.5154,0,12613872,11173802,1440070,28.8014,9.3069,0.5826,6170001,4265890,1904111,38.0822
server_029,1.53863,31533499,28205829,3327670,66.5534,0,12631121,11168969,1462152,29.243,9.6545,0.6841,6176002,4212348,1963654,39.2731
server_030,1.62359,31052494,27716294,3336200,66.724,0,12713187,11252368,1460819,29.2164,10.7059,0.1636,6230807,4272463,1958344,39.1669
server_031,1.51457,32099934,28701803,3398131,67.9626,0,12896842,11659016,1237826,24.7565,8.0366,0.725,6376387,4403854,1972533,39.4507
server_032,1.64039,32597743,29029420,3568323,71.3665,0,13162918,12026757,1136161,22.7232,4.4443,0.0671,6632644,4552182,2080462,41.6092
server_033,1.7719,31981876,28447516,3534360,70.6872,0,12136150,11500291,635859,12.7172,4.4105,0.362,6868366,4506793,2361573,47.2315
server_034,1.89113,31422983,27894000,3528983,70.5797,0,12130368,11524633,605735,12.1147,0.9872,0.0941,6875851,4509598,2366253,47.3251
server_035,1.36605,31794950,28268971,3525979,70.5196,0,12076214,11434062,642152,12.843,4.9644,3.4889,6837785,4380677,2457108,49.1422
server_036,1.76372,31619422,27689493,3929929,78.5986,0,13756859,13752939,3920,0.0784,0.0358,0.0307,6301409,3788154,2513255,50.2651
server_037,1.78141,32615555,28437959,4177596,83.5519,0,12413805,11977151,436654,8.7331,3.5985,0.451,6799478,3890679,2908799,58.176
server_038,1.78674,32602423,28456830,4145593,82.9119,0,12421672,11983584,438088,8.7618,3.3192,0.4323,6801786,3875003,2926783,58.5357
server_039,1.70466,31597628,27208145,4389483,87.7897,0,13601647,13550594,51053,1.0211,0.0001,0.0001,6580129,3936283,2643846,52.8769
spec_gcc_001,1.60182,32312859,32078386,234473,4.6895,0,11618890,10846949,771941,15.4388,3.4756,1.0072,6498067,6349769,148298,2.966
spec_gcc_002,0.231908,20654397,20067302,587095,11.7419,0,13370444,8356971,5013473,100.2695,104.2536,58.8221,3717432,3346353,371079,7.4216
spec_gcc_003,0.252313,19719127,18986275,732852,14.657,0,12224392,6673580,5550812,111.0162,117.6661,75.7641,3560893,3074974,485919,9.7184
spec_gobmk_001,1.57698,24913037,24388710,524327,10.4865,0,9545816,9309177,236639,4.7328,1.839,0.292,4310184,4028158,282026,5.6405
spec_gobmk_002,1.98704,26721246,25918252,802994,16.0599,0,9489977,9416842,73135,1.4627,0.5164,0.3749,5677419,5250433,426986,8.5397
spec_perlbench_001,1.6795,28476661,28155559,321102,6.422,0,11979657,11735623,244034,4.8807,2.3495,1.6927,6596095,6419475,176620,3.5324
spec_x264_001,3.27026,11017650,10754867,262783,5.2557,0,6494392,6426197,68195,1.3639,0.7159,0.5534,1709708,1663427,46281,0.9256
